#,#,#,#,#,#,#,#,#,#,#,#,#
#,,,,#,,,,#,,,,#
#,,S,,,,,,,,,,#
#,,,,#,,,,#,,,,#
#,#,#,#,#,,,,#,#,#,#,#
#,,,,#,,,,#,,,,#
#,,,,,,,,,,F,,#
#,,,,#,,,,#,,,,#
#,#,#,#,#,#,#,#,#,#,#,#,#
