#,#,#,#,#,#,#,#,#
#,,,,#,,,,#
#,,S,,,,,,#
#,,,,#,,,,#
#,#,#,#,#,,,,#
#,,,,#,,,,#
#,,,,,,,,#
#,,,,#,,,,#
#,#,#,#,#,,,,#
#,,,,#,,,,#
#,,,,,,,,#
#,,,,#,,,,#
#,#,#,#,#,,,,#
#,,,,#,,,,#
#,,F,,,,,,#
#,,,,#,,,,#
#,#,#,#,#,#,#,#,#
